R      1000 720

NO ./textures/minecraft/dirt.xpm
SO ./textures/minecraft/mossy_cobblestone.xpm
WE ./textures/minecraft/sandstone_bottom.xpm
EA ./textures/minecraft/stone_bricks.xpm
S ./textures/minecraft/grass.xpm

FT ./textures/minecraft/ice.xpm
CT ./textures/minecraft/mossy_cobblestone.xpm

F   69, 69, 69
C 44, 152, 199

11111111111111111111111111111
12222222222222222222222222221
12222222222222222222222222221
12222222222222222222222222221
12222222222222222222222222221
12222222222222222222222222221
12222222222222222222222222221
12222222222222222222222222221
12222222222222222222222222221
12222222222222222222222222221
12222222222222222222222222221
1222222222222N222222222222221
12222222222222222222222222221
12222222222222222222222222221
12222222222222222222222222221
12222222222222222222222222221
12222222222222222222222222221
12222222222222222222222222221
12222222222222222222222222221
12222222222222222222222222221
11111111111111111111111111111