R 1000 720

NO ./textures/minecraft/dirt.xpm
SO ./textures/minecraft/mossy_cobblestone.xpm
WE ./textures/minecraft/sandstone_bottom.xpm
EA ./textures/minecraft/stone_bricks.xpm
S ./textures/minecraft/grass.xpm

SI ./textures/minecraft/diamond.xpm
AI ./textures/minecraft/item.wav

FT ./textures/minecraft/ice.xpm
CT ./textures/minecraft/mossy_cobblestone.xpm

F   69, 69, 69
C 44, 152, 199

11111111111111111111111111111
13333333333333333333333333331
13333333333333333333333333331
13333333333333333333333333331
13333333333333333333333333331
13333333333333333333333333331
13333333333333333333333333331
13333333333333333333333333331
13333333333333333333333333331
13333333333333333333333333331
13333333333333333333333333331
1333333333333N333333333333331
13333333333333333333333333331
13333333333333333333333333331
13333333333333333333333333331
13333333333333333333333333331
13333333333333333333333333331
13333333333333333333333333331
13333333333333333333333333331
13333333333333333333333333331
11111111111111111111111111111