R 800 800

NO ./textures/minecraft/dirt.xpm
SO ./textures/minecraft/mossy_cobblestone.xpm
WE ./textures/minecraft/sandstone_bottom.xpm
EA ./textures/minecraft/stone_bricks.xpm
S ./textures/minecraft/grass.xpm

C 210, 210,210
F 69,69,  69

0 0 0 0 0 0 0 0 0 1 1 1 
0 0 0 0 0 0 0 0 1 1 0 1 1
0 0 0 0 0 0 0 0 1 0 2 0 1
0 0 0 0 0 0 0 0 1 0 0 0 1
0 0 0 0 0 0 0 0 1 1 0 1 1 0
0 0 0 0 0 0 0 0 1 0 0 0 1
0 0 0 0 0 0 0 0 1 0 0 0 10000000
0 0 0 0 0 0 0 0 1 0 0 0 1
0 0 0 0 0 0 0 0 1 0 0 0 1
0 0 0 0 0 0 0 0 1 0 0 0 1 0
0 0 0 0 0 0 0 0 1 0 0 0 1
0 0 0 0 0 0 0 0 1 0 0 0 1
0 0 0 0 1 1 1 1 1 0 0 0 1 1 1 1 1
0 0 0 1 1 0 0 0 0 0 0 0 0 0 0 0 1 1
0 0 0 1 0 0 0 0 0 0 0 0 0 0 0 0 0 1
0 0 0 1 0 0 0 0 0 0 0 0 N 0 0 0 0 1
0 0 0 1 0 0 0 0 0 0 0 0 0 0 0 0 0 1
0 0 0 1 0 0 0 0 0 0 0 0 0 0 0 0 0 1
0 0 0 1 1 2 2 2 2 1 1 1 2 2 2 2 1 1
0 0 0 0 1 1 1 1 1 1 0 1 1 1 1 1 1
0 0 0 0 0 0 0 0 0 0 0 0 0 0 0 0 0
0 0 0 0 0 0 0 0 0 0 0 0 0 0 0 0 0
0 0 0 0 0 0 0 0 0 0 0 0 0 0 0 0 0
