R 800 800

NO ./textures/minecraft/stone_bricks.xpm
SO ./textures/minecraft/stone_bricks.xpm
WE ./textures/minecraft/stone_bricks.xpm
EA ./textures/minecraft/stone_bricks.xpm
S ./textures/minecraft/grass.xpm

FT ./textures/minecraft/acacia_planks.xpm
CT ./textures/minecraft/mossy_cobblestone.xpm
DH ./textures/minecraft/mossy_stone_bricks.xpm

XH ./textures/hudz.xpm
XT ./textures/minecraft/creeper.xpm

SI ./textures/minecraft/diamond.xpm
SC ./textures/minecraft/pillar.xpm

F   69, 69, 69
C 44, 152, 199

        1111111111111111111111111
        1000000000110000000000001
        1011000001110000002000001
        1001000000000000000000001
111111111011000001110000000000001
100000000011000001110111110111111
11110111111111011100000010001
11110111111111011101010010001
11000000110101011100000010001
10002000000000001100000010001
100N0000000000001101010010001
1100000111010101111101111000111
11110111 1110101 101111010011
11111111 1111111 111111111110