R 800 800

NO ./textures/minecraft/stone_bricks.xpm
SO ./textures/minecraft/stone_bricks.xpm
WE ./textures/minecraft/stone_bricks.xpm
EA ./textures/minecraft/stone_bricks.xpm
S ./textures/minecraft/grass.xpm

FT ./textures/minecraft/acacia_planks.xpm
CT ./textures/minecraft/mossy_cobblestone.xpm
DH ./textures/minecraft/mossy_stone_bricks.xpm

F 69,69,69
C 44,152,199

11111111111111111111111111111
10000000000000000000000000001
10000000000000000000000000001
10000000000000000000000000001
10000000000000000000000000001
10000000000000000000000000001
10000000000000000000000000001
10000000000000000000000000001
10000000000000000000000000001
10000000000000N00000000000001
10000000000000000000000000001
10000000000000000000000000001
10000000000000000000000000001
10000000000000000000000000001
10000000000000000000000000001
10000000000000000000000000001
10000000000000000000000000001
10000000000000000000000000001
11111111111111111111111111111