R 800 800

NO ./textures/minecraft/stone_bricks.xpm
SO ./textures/minecraft/stone_bricks.xpm
WE ./textures/minecraft/stone_bricks.xpm
EA ./textures/minecraft/stone_bricks.xpm
S ./textures/minecraft/grass.xpm

FT ./textures/minecraft/acacia_planks.xpm
CT ./textures/minecraft/mossy_cobblestone.xpm
DH ./textures/minecraft/mossy_stone_bricks.xpm

XH ./textures/hudz.xpm
XT ./textures/minecraft/creeper.xpm

SI ./textures/minecraft/diamond.xpm
SC ./textures/minecraft/pillar.xpm

F 69, 69, 69
C 44, 152, 199

11111111111111111111111111111
130T0000001100000000000210001
101100000111000000000002T0031
10110000000000000000000210001
10110000011100000002222210001
100H00000011000001111H1110001
11110111111111011100000010001
11110111111111011100404010001
110000001101310111000000H0001
10400000000002000400000010001
100030000000020W0400000013331
1100000T110101H11111010113331
11110111111131311111010013311
01111111111111111111111111110